W W W W W W W W W W W W W W W W W W W
W B S S S W S S S X S S S W S S S B W
W S W W S W S W W W W W S W S W W S W
W S S S S S S S S S S S S S S S S S W
W W S W S W W W S W S W W W S W S W W
E E S W S S S S S W S S S S S W S E E
W W S W W W S W W W W W S W W W S W W
W W S S S S S S S S S S S S S S S W W
W W S W W W S W E W E W S W W W S W W
W W Z W S S S W 1 3 2 W S S S W S W W
W W S W S W S W W W W W S W S W S W W
E E S S S W S S S S S S S W S S S E E
W W S W W W W W S W S W W W W W S W W
W W S S S S S S S W S S S S S S S W W
W W S W W W S W W W W W S W W W S W W
W S S S S S S S S P S S S S S S S S W
W S W W S W W W S W S W W W S W W S W
W S W W S W S S S W S S S W S W W S W
W S W W S W S W W W W W S W S W W S W
W B S S S S S S S Y S S S S S S S B W
W W W W W W W W W W W W W W W W W W W