W W W W W W W W W W W W W W W W W W W
W B S S S W S S S S S S S W S S S B W
W S W W S W S W W W W W S W S W W S W
W S W W S S S S S W S S S S S W W S W
W S W W S W S W S W S W S W S W W S W
W S W W S W S W S W S W S W S W W S W
W S W W S W S W S S S W Y W S W W S W
W S W W S W S W W W W W S W S W W S W
W S W W S S S S S S S S S S S W W S W
W S S S S W S W E W E W S W S S S S W
W W W W W W S W 1 3 2 W S W W W W W W
W S S S X W S W W W W W S W S S S S W
W S W W S W S S S S S S S W S W W S W 
W S W W S W S W W W W W S W S W W S W
W S W W S W S S S W S S Z W S W W S W
W S W W S S S S S P S S S S S W W S W 
W S W W S W W W S W S W W W S W W S W 
W S W W S W S S S W S S S W S W W S W
W S W W S W S W W W W W S W S W W S W
W B S S S W S S S S S S S W S S S B W
W W W W W W W W W W W W W W W W W W W