W W W W W W W W W W W W W W W W W W W
W B Z S S S S S S W S S S S S S S B W
W S W W S W W W W W W W W W S W W S W
W S S S S S S S S S S S S S S S S S W
W S W W S W S W W W W W S W S W W S W
W S S S S W S S S W S S S W S S S X W
W W W W S W W W S W S W W W S W W W W
W S S S S W S S S S S S S W S S S S W
W W S W S W S W E W E W S W S W S W W
W S S S S S S W 1 3 2 W S S S S S S W
W W S W S W S W W W W W S W S W S W W
W S S S S W S S S S S S S W S S S S W
W W W W S W S W W W W W S W S W W W W
W S S S S S S S S W S S S S S S S S W
W S W W S W W W W W W W W W S W W S W
W S Y W S S S S S P S S S S S W S S W
W W S W S W S W W W W W S W S W S W W
W S S S S W S S S W S S S W S S S S W
W S W W W W W W S W S W W W W W W S W
W B S S S S S S S S S S S S S S S B W
W W W W W W W W W W W W W W W W W W W